"filename", "language", "TypeScript", "TypeScript JSX", "comment", "blank", "total"
"d:\Web development\basic projects\projects fot job\potfoliio projects\portfolio projects\portfolioproject with livechat\portpolio-with-liveChat\gemini-cli\packages\cli\src\config\auth.ts", "TypeScript", 29, 0, 5, 6, 40
"d:\Web development\basic projects\projects fot job\potfoliio projects\portfolio projects\portfolioproject with livechat\portpolio-with-liveChat\gemini-cli\packages\cli\src\config\config.integration.test.ts", "TypeScript", 198, 0, 10, 36, 244
"d:\Web development\basic projects\projects fot job\potfoliio projects\portfolio projects\portfolioproject with livechat\portpolio-with-liveChat\gemini-cli\packages\cli\src\config\config.test.ts", "TypeScript", 288, 0, 27, 38, 353
"d:\Web development\basic projects\projects fot job\potfoliio projects\portfolio projects\portfolioproject with livechat\portpolio-with-liveChat\gemini-cli\packages\cli\src\config\config.ts", "TypeScript", 262, 0, 23, 18, 303
"d:\Web development\basic projects\projects fot job\potfoliio projects\portfolio projects\portfolioproject with livechat\portpolio-with-liveChat\gemini-cli\packages\cli\src\config\extension.test.ts", "TypeScript", 90, 0, 5, 15, 110
"d:\Web development\basic projects\projects fot job\potfoliio projects\portfolio projects\portfolioproject with livechat\portpolio-with-liveChat\gemini-cli\packages\cli\src\config\extension.ts", "TypeScript", 94, 0, 5, 17, 116
"d:\Web development\basic projects\projects fot job\potfoliio projects\portfolio projects\portfolioproject with livechat\portpolio-with-liveChat\gemini-cli\packages\cli\src\config\sandboxConfig.ts", "TypeScript", 80, 0, 13, 15, 108
"d:\Web development\basic projects\projects fot job\potfoliio projects\portfolio projects\portfolioproject with livechat\portpolio-with-liveChat\gemini-cli\packages\cli\src\config\settings.test.ts", "TypeScript", 539, 0, 23, 73, 635
"d:\Web development\basic projects\projects fot job\potfoliio projects\portfolio projects\portfolioproject with livechat\portpolio-with-liveChat\gemini-cli\packages\cli\src\config\settings.ts", "TypeScript", 218, 0, 17, 31, 266
"d:\Web development\basic projects\projects fot job\potfoliio projects\portfolio projects\portfolioproject with livechat\portpolio-with-liveChat\gemini-cli\packages\cli\src\gemini.test.tsx", "TypeScript JSX", 0, 116, 12, 19, 147
"d:\Web development\basic projects\projects fot job\potfoliio projects\portfolio projects\portfolioproject with livechat\portpolio-with-liveChat\gemini-cli\packages\cli\src\gemini.tsx", "TypeScript JSX", 0, 238, 27, 33, 298
"d:\Web development\basic projects\projects fot job\potfoliio projects\portfolio projects\portfolioproject with livechat\portpolio-with-liveChat\gemini-cli\packages\cli\src\nonInteractiveCli.test.ts", "TypeScript", 244, 0, 9, 34, 287
"d:\Web development\basic projects\projects fot job\potfoliio projects\portfolio projects\portfolioproject with livechat\portpolio-with-liveChat\gemini-cli\packages\cli\src\nonInteractiveCli.ts", "TypeScript", 134, 0, 8, 15, 157
"d:\Web development\basic projects\projects fot job\potfoliio projects\portfolio projects\portfolioproject with livechat\portpolio-with-liveChat\gemini-cli\packages\cli\src\ui\App.test.tsx", "TypeScript JSX", 0, 403, 14, 45, 462
"d:\Web development\basic projects\projects fot job\potfoliio projects\portfolio projects\portfolioproject with livechat\portpolio-with-liveChat\gemini-cli\packages\cli\src\ui\App.tsx", "TypeScript JSX", 0, 736, 34, 61, 831
"d:\Web development\basic projects\projects fot job\potfoliio projects\portfolio projects\portfolioproject with livechat\portpolio-with-liveChat\gemini-cli\packages\cli\src\ui\colors.ts", "TypeScript", 43, 0, 5, 3, 51
"d:\Web development\basic projects\projects fot job\potfoliio projects\portfolio projects\portfolioproject with livechat\portpolio-with-liveChat\gemini-cli\packages\cli\src\ui\components\AboutBox.tsx", "TypeScript JSX", 0, 111, 5, 4, 120
"d:\Web development\basic projects\projects fot job\potfoliio projects\portfolio projects\portfolioproject with livechat\portpolio-with-liveChat\gemini-cli\packages\cli\src\ui\components\AsciiArt.ts", "TypeScript", 20, 0, 5, 3, 28
"d:\Web development\basic projects\projects fot job\potfoliio projects\portfolio projects\portfolioproject with livechat\portpolio-with-liveChat\gemini-cli\packages\cli\src\ui\components\AuthDialog.test.tsx", "TypeScript JSX", 0, 84, 9, 14, 107
"d:\Web development\basic projects\projects fot job\potfoliio projects\portfolio projects\portfolioproject with livechat\portpolio-with-liveChat\gemini-cli\packages\cli\src\ui\components\AuthDialog.tsx", "TypeScript JSX", 0, 87, 6, 9, 102
"d:\Web development\basic projects\projects fot job\potfoliio projects\portfolio projects\portfolioproject with livechat\portpolio-with-liveChat\gemini-cli\packages\cli\src\ui\components\AuthInProgress.tsx", "TypeScript JSX", 0, 45, 5, 8, 58
"d:\Web development\basic projects\projects fot job\potfoliio projects\portfolio projects\portfolioproject with livechat\portpolio-with-liveChat\gemini-cli\packages\cli\src\ui\components\AutoAcceptIndicator.tsx", "TypeScript JSX", 0, 37, 5, 6, 48
"d:\Web development\basic projects\projects fot job\potfoliio projects\portfolio projects\portfolioproject with livechat\portpolio-with-liveChat\gemini-cli\packages\cli\src\ui\components\ConsolePatcher.tsx", "TypeScript JSX", 0, 46, 6, 9, 61
"d:\Web development\basic projects\projects fot job\potfoliio projects\portfolio projects\portfolioproject with livechat\portpolio-with-liveChat\gemini-cli\packages\cli\src\ui\components\ConsoleSummaryDisplay.tsx", "TypeScript JSX", 0, 24, 6, 6, 36
"d:\Web development\basic projects\projects fot job\potfoliio projects\portfolio projects\portfolioproject with livechat\portpolio-with-liveChat\gemini-cli\packages\cli\src\ui\components\ContextSummaryDisplay.tsx", "TypeScript JSX", 0, 53, 6, 9, 68
"d:\Web development\basic projects\projects fot job\potfoliio projects\portfolio projects\portfolioproject with livechat\portpolio-with-liveChat\gemini-cli\packages\cli\src\ui\components\DetailedMessagesDisplay.tsx", "TypeScript JSX", 0, 68, 8, 7, 83
"d:\Web development\basic projects\projects fot job\potfoliio projects\portfolio projects\portfolioproject with livechat\portpolio-with-liveChat\gemini-cli\packages\cli\src\ui\components\EditorSettingsDialog.tsx", "TypeScript JSX", 0, 149, 5, 15, 169
"d:\Web development\basic projects\projects fot job\potfoliio projects\portfolio projects\portfolioproject with livechat\portpolio-with-liveChat\gemini-cli\packages\cli\src\ui\components\Footer.tsx", "TypeScript JSX", 0, 97, 7, 6, 110
"d:\Web development\basic projects\projects fot job\potfoliio projects\portfolio projects\portfolioproject with livechat\portpolio-with-liveChat\gemini-cli\packages\cli\src\ui\components\GeminiRespondingSpinner.tsx", "TypeScript JSX", 0, 21, 9, 5, 35
"d:\Web development\basic projects\projects fot job\potfoliio projects\portfolio projects\portfolioproject with livechat\portpolio-with-liveChat\gemini-cli\packages\cli\src\ui\components\Header.tsx", "TypeScript JSX", 0, 40, 5, 7, 52
"d:\Web development\basic projects\projects fot job\potfoliio projects\portfolio projects\portfolioproject with livechat\portpolio-with-liveChat\gemini-cli\packages\cli\src\ui\components\Help.tsx", "TypeScript JSX", 0, 116, 8, 8, 132
"d:\Web development\basic projects\projects fot job\potfoliio projects\portfolio projects\portfolioproject with livechat\portpolio-with-liveChat\gemini-cli\packages\cli\src\ui\components\HistoryItemDisplay.test.tsx", "TypeScript JSX", 0, 97, 6, 10, 113
"d:\Web development\basic projects\projects fot job\potfoliio projects\portfolio projects\portfolioproject with livechat\portpolio-with-liveChat\gemini-cli\packages\cli\src\ui\components\HistoryItemDisplay.tsx", "TypeScript JSX", 0, 83, 6, 4, 93
"d:\Web development\basic projects\projects fot job\potfoliio projects\portfolio projects\portfolioproject with livechat\portpolio-with-liveChat\gemini-cli\packages\cli\src\ui\components\InputPrompt.test.tsx", "TypeScript JSX", 0, 154, 5, 29, 188
"d:\Web development\basic projects\projects fot job\potfoliio projects\portfolio projects\portfolioproject with livechat\portpolio-with-liveChat\gemini-cli\packages\cli\src\ui\components\InputPrompt.tsx", "TypeScript JSX", 0, 404, 21, 27, 452
"d:\Web development\basic projects\projects fot job\potfoliio projects\portfolio projects\portfolioproject with livechat\portpolio-with-liveChat\gemini-cli\packages\cli\src\ui\components\LoadingIndicator.test.tsx", "TypeScript JSX", 0, 188, 9, 18, 215
"d:\Web development\basic projects\projects fot job\potfoliio projects\portfolio projects\portfolioproject with livechat\portpolio-with-liveChat\gemini-cli\packages\cli\src\ui\components\LoadingIndicator.tsx", "TypeScript JSX", 0, 48, 6, 7, 61
"d:\Web development\basic projects\projects fot job\potfoliio projects\portfolio projects\portfolioproject with livechat\portpolio-with-liveChat\gemini-cli\packages\cli\src\ui\components\MemoryUsageDisplay.tsx", "TypeScript JSX", 0, 27, 5, 5, 37
"d:\Web development\basic projects\projects fot job\potfoliio projects\portfolio projects\portfolioproject with livechat\portpolio-with-liveChat\gemini-cli\packages\cli\src\ui\components\ModelStatsDisplay.test.tsx", "TypeScript JSX", 0, 212, 6, 18, 236
"d:\Web development\basic projects\projects fot job\potfoliio projects\portfolio projects\portfolioproject with livechat\portpolio-with-liveChat\gemini-cli\packages\cli\src\ui\components\ModelStatsDisplay.tsx", "TypeScript JSX", 0, 173, 9, 16, 198
"d:\Web development\basic projects\projects fot job\potfoliio projects\portfolio projects\portfolioproject with livechat\portpolio-with-liveChat\gemini-cli\packages\cli\src\ui\components\SessionSummaryDisplay.test.tsx", "TypeScript JSX", 0, 54, 5, 9, 68
"d:\Web development\basic projects\projects fot job\potfoliio projects\portfolio projects\portfolioproject with livechat\portpolio-with-liveChat\gemini-cli\packages\cli\src\ui\components\SessionSummaryDisplay.tsx", "TypeScript JSX", 0, 10, 5, 4, 19
"d:\Web development\basic projects\projects fot job\potfoliio projects\portfolio projects\portfolioproject with livechat\portpolio-with-liveChat\gemini-cli\packages\cli\src\ui\components\ShellModeIndicator.tsx", "TypeScript JSX", 0, 11, 5, 3, 19
"d:\Web development\basic projects\projects fot job\potfoliio projects\portfolio projects\portfolioproject with livechat\portpolio-with-liveChat\gemini-cli\packages\cli\src\ui\components\ShowMoreLines.tsx", "TypeScript JSX", 0, 30, 5, 6, 41
"d:\Web development\basic projects\projects fot job\potfoliio projects\portfolio projects\portfolioproject with livechat\portpolio-with-liveChat\gemini-cli\packages\cli\src\ui\components\StatsDisplay.test.tsx", "TypeScript JSX", 0, 270, 6, 28, 304
"d:\Web development\basic projects\projects fot job\potfoliio projects\portfolio projects\portfolioproject with livechat\portpolio-with-liveChat\gemini-cli\packages\cli\src\ui\components\StatsDisplay.tsx", "TypeScript JSX", 0, 228, 13, 19, 260
"d:\Web development\basic projects\projects fot job\potfoliio projects\portfolio projects\portfolioproject with livechat\portpolio-with-liveChat\gemini-cli\packages\cli\src\ui\components\SuggestionsDisplay.tsx", "TypeScript JSX", 0, 77, 8, 9, 94
"d:\Web development\basic projects\projects fot job\potfoliio projects\portfolio projects\portfolioproject with livechat\portpolio-with-liveChat\gemini-cli\packages\cli\src\ui\components\ThemeDialog.tsx", "TypeScript JSX", 0, 207, 26, 26, 259
"d:\Web development\basic projects\projects fot job\potfoliio projects\portfolio projects\portfolioproject with livechat\portpolio-with-liveChat\gemini-cli\packages\cli\src\ui\components\Tips.tsx", "TypeScript JSX", 0, 37, 5, 4, 46
"d:\Web development\basic projects\projects fot job\potfoliio projects\portfolio projects\portfolioproject with livechat\portpolio-with-liveChat\gemini-cli\packages\cli\src\ui\components\ToolStatsDisplay.test.tsx", "TypeScript JSX", 0, 155, 6, 16, 177
"d:\Web development\basic projects\projects fot job\potfoliio projects\portfolio projects\portfolioproject with livechat\portpolio-with-liveChat\gemini-cli\packages\cli\src\ui\components\ToolStatsDisplay.tsx", "TypeScript JSX", 0, 182, 10, 17, 209
"d:\Web development\basic projects\projects fot job\potfoliio projects\portfolio projects\portfolioproject with livechat\portpolio-with-liveChat\gemini-cli\packages\cli\src\ui\components\UpdateNotification.tsx", "TypeScript JSX", 0, 15, 5, 4, 24
"d:\Web development\basic projects\projects fot job\potfoliio projects\portfolio projects\portfolioproject with livechat\portpolio-with-liveChat\gemini-cli\packages\cli\src\ui\components\messages\CompressionMessage.tsx", "TypeScript JSX", 0, 36, 9, 5, 50
"d:\Web development\basic projects\projects fot job\potfoliio projects\portfolio projects\portfolioproject with livechat\portpolio-with-liveChat\gemini-cli\packages\cli\src\ui\components\messages\DiffRenderer.test.tsx", "TypeScript JSX", 0, 335, 8, 20, 363
"d:\Web development\basic projects\projects fot job\potfoliio projects\portfolio projects\portfolioproject with livechat\portpolio-with-liveChat\gemini-cli\packages\cli\src\ui\components\messages\DiffRenderer.tsx", "TypeScript JSX", 0, 262, 23, 28, 313
"d:\Web development\basic projects\projects fot job\potfoliio projects\portfolio projects\portfolioproject with livechat\portpolio-with-liveChat\gemini-cli\packages\cli\src\ui\components\messages\ErrorMessage.tsx", "TypeScript JSX", 0, 22, 5, 5, 32
"d:\Web development\basic projects\projects fot job\potfoliio projects\portfolio projects\portfolioproject with livechat\portpolio-with-liveChat\gemini-cli\packages\cli\src\ui\components\messages\GeminiMessage.tsx", "TypeScript JSX", 0, 34, 5, 5, 44
"d:\Web development\basic projects\projects fot job\potfoliio projects\portfolio projects\portfolioproject with livechat\portpolio-with-liveChat\gemini-cli\packages\cli\src\ui\components\messages\GeminiMessageContent.tsx", "TypeScript JSX", 0, 28, 11, 5, 44
"d:\Web development\basic projects\projects fot job\potfoliio projects\portfolio projects\portfolioproject with livechat\portpolio-with-liveChat\gemini-cli\packages\cli\src\ui\components\messages\InfoMessage.tsx", "TypeScript JSX", 0, 22, 5, 5, 32
"d:\Web development\basic projects\projects fot job\potfoliio projects\portfolio projects\portfolioproject with livechat\portpolio-with-liveChat\gemini-cli\packages\cli\src\ui\components\messages\ToolConfirmationMessage.test.tsx", "TypeScript JSX", 0, 46, 5, 8, 59
"d:\Web development\basic projects\projects fot job\potfoliio projects\portfolio projects\portfolioproject with livechat\portpolio-with-liveChat\gemini-cli\packages\cli\src\ui\components\messages\ToolConfirmationMessage.tsx", "TypeScript JSX", 0, 213, 15, 23, 251
"d:\Web development\basic projects\projects fot job\potfoliio projects\portfolio projects\portfolioproject with livechat\portpolio-with-liveChat\gemini-cli\packages\cli\src\ui\components\messages\ToolGroupMessage.tsx", "TypeScript JSX", 0, 100, 16, 8, 124
"d:\Web development\basic projects\projects fot job\potfoliio projects\portfolio projects\portfolioproject with livechat\portpolio-with-liveChat\gemini-cli\packages\cli\src\ui\components\messages\ToolMessage.test.tsx", "TypeScript JSX", 0, 153, 12, 17, 182
"d:\Web development\basic projects\projects fot job\potfoliio projects\portfolio projects\portfolioproject with livechat\portpolio-with-liveChat\gemini-cli\packages\cli\src\ui\components\messages\ToolMessage.tsx", "TypeScript JSX", 0, 172, 11, 12, 195
"d:\Web development\basic projects\projects fot job\potfoliio projects\portfolio projects\portfolioproject with livechat\portpolio-with-liveChat\gemini-cli\packages\cli\src\ui\components\messages\UserMessage.tsx", "TypeScript JSX", 0, 30, 5, 5, 40
"d:\Web development\basic projects\projects fot job\potfoliio projects\portfolio projects\portfolioproject with livechat\portpolio-with-liveChat\gemini-cli\packages\cli\src\ui\components\messages\UserShellMessage.tsx", "TypeScript JSX", 0, 15, 6, 5, 26
"d:\Web development\basic projects\projects fot job\potfoliio projects\portfolio projects\portfolioproject with livechat\portpolio-with-liveChat\gemini-cli\packages\cli\src\ui\components\shared\MaxSizedBox.test.tsx", "TypeScript JSX", 0, 297, 16, 30, 343
"d:\Web development\basic projects\projects fot job\potfoliio projects\portfolio projects\portfolioproject with livechat\portpolio-with-liveChat\gemini-cli\packages\cli\src\ui\components\shared\MaxSizedBox.tsx", "TypeScript JSX", 0, 394, 98, 56, 548
"d:\Web development\basic projects\projects fot job\potfoliio projects\portfolio projects\portfolioproject with livechat\portpolio-with-liveChat\gemini-cli\packages\cli\src\ui\components\shared\RadioButtonSelect.tsx", "TypeScript JSX", 0, 95, 33, 15, 143
"d:\Web development\basic projects\projects fot job\potfoliio projects\portfolio projects\portfolioproject with livechat\portpolio-with-liveChat\gemini-cli\packages\cli\src\ui\components\shared\text-buffer.test.ts", "TypeScript", 969, 0, 56, 99, 1124
"d:\Web development\basic projects\projects fot job\potfoliio projects\portfolio projects\portfolioproject with livechat\portpolio-with-liveChat\gemini-cli\packages\cli\src\ui\components\shared\text-buffer.ts", "TypeScript", 1230, 0, 174, 124, 1528
"d:\Web development\basic projects\projects fot job\potfoliio projects\portfolio projects\portfolioproject with livechat\portpolio-with-liveChat\gemini-cli\packages\cli\src\ui\constants.ts", "TypeScript", 6, 0, 6, 4, 16
"d:\Web development\basic projects\projects fot job\potfoliio projects\portfolio projects\portfolioproject with livechat\portpolio-with-liveChat\gemini-cli\packages\cli\src\ui\contexts\OverflowContext.tsx", "TypeScript JSX", 0, 69, 5, 14, 88
"d:\Web development\basic projects\projects fot job\potfoliio projects\portfolio projects\portfolioproject with livechat\portpolio-with-liveChat\gemini-cli\packages\cli\src\ui\contexts\SessionContext.test.tsx", "TypeScript JSX", 0, 107, 12, 14, 133
"d:\Web development\basic projects\projects fot job\potfoliio projects\portfolio projects\portfolioproject with livechat\portpolio-with-liveChat\gemini-cli\packages\cli\src\ui\contexts\SessionContext.tsx", "TypeScript JSX", 0, 89, 12, 19, 120
"d:\Web development\basic projects\projects fot job\potfoliio projects\portfolio projects\portfolioproject with livechat\portpolio-with-liveChat\gemini-cli\packages\cli\src\ui\contexts\StreamingContext.tsx", "TypeScript JSX", 0, 14, 5, 4, 23
"d:\Web development\basic projects\projects fot job\potfoliio projects\portfolio projects\portfolioproject with livechat\portpolio-with-liveChat\gemini-cli\packages\cli\src\ui\editors\editorSettingsManager.ts", "TypeScript", 57, 0, 5, 10, 72
"d:\Web development\basic projects\projects fot job\potfoliio projects\portfolio projects\portfolioproject with livechat\portpolio-with-liveChat\gemini-cli\packages\cli\src\ui\hooks\atCommandProcessor.test.ts", "TypeScript", 659, 0, 31, 66, 756
"d:\Web development\basic projects\projects fot job\potfoliio projects\portfolio projects\portfolioproject with livechat\portpolio-with-liveChat\gemini-cli\packages\cli\src\ui\hooks\atCommandProcessor.ts", "TypeScript", 352, 0, 42, 32, 426
"d:\Web development\basic projects\projects fot job\potfoliio projects\portfolio projects\portfolioproject with livechat\portpolio-with-liveChat\gemini-cli\packages\cli\src\ui\hooks\shellCommandProcessor.test.ts", "TypeScript", 140, 0, 8, 32, 180
"d:\Web development\basic projects\projects fot job\potfoliio projects\portfolio projects\portfolioproject with livechat\portpolio-with-liveChat\gemini-cli\packages\cli\src\ui\hooks\shellCommandProcessor.ts", "TypeScript", 268, 0, 42, 39, 349
"d:\Web development\basic projects\projects fot job\potfoliio projects\portfolio projects\portfolioproject with livechat\portpolio-with-liveChat\gemini-cli\packages\cli\src\ui\hooks\slashCommandProcessor.test.ts", "TypeScript", 1100, 0, 59, 150, 1309
"d:\Web development\basic projects\projects fot job\potfoliio projects\portfolio projects\portfolioproject with livechat\portpolio-with-liveChat\gemini-cli\packages\cli\src\ui\hooks\slashCommandProcessor.ts", "TypeScript", 1001, 0, 41, 70, 1112
"d:\Web development\basic projects\projects fot job\potfoliio projects\portfolio projects\portfolioproject with livechat\portpolio-with-liveChat\gemini-cli\packages\cli\src\ui\hooks\useAuthCommand.ts", "TypeScript", 61, 0, 5, 11, 77
"d:\Web development\basic projects\projects fot job\potfoliio projects\portfolio projects\portfolioproject with livechat\portpolio-with-liveChat\gemini-cli\packages\cli\src\ui\hooks\useAutoAcceptIndicator.test.ts", "TypeScript", 237, 0, 6, 34, 277
"d:\Web development\basic projects\projects fot job\potfoliio projects\portfolio projects\portfolioproject with livechat\portpolio-with-liveChat\gemini-cli\packages\cli\src\ui\hooks\useAutoAcceptIndicator.ts", "TypeScript", 35, 0, 6, 9, 50
"d:\Web development\basic projects\projects fot job\potfoliio projects\portfolio projects\portfolioproject with livechat\portpolio-with-liveChat\gemini-cli\packages\cli\src\ui\hooks\useBracketedPaste.ts", "TypeScript", 20, 0, 11, 7, 38
"d:\Web development\basic projects\projects fot job\potfoliio projects\portfolio projects\portfolioproject with livechat\portpolio-with-liveChat\gemini-cli\packages\cli\src\ui\hooks\useCompletion.integration.test.ts", "TypeScript", 257, 0, 23, 52, 332
"d:\Web development\basic projects\projects fot job\potfoliio projects\portfolio projects\portfolioproject with livechat\portpolio-with-liveChat\gemini-cli\packages\cli\src\ui\hooks\useCompletion.ts", "TypeScript", 376, 0, 26, 48, 450
"d:\Web development\basic projects\projects fot job\potfoliio projects\portfolio projects\portfolioproject with livechat\portpolio-with-liveChat\gemini-cli\packages\cli\src\ui\hooks\useConsoleMessages.test.ts", "TypeScript", 157, 0, 16, 40, 213
"d:\Web development\basic projects\projects fot job\potfoliio projects\portfolio projects\portfolioproject with livechat\portpolio-with-liveChat\gemini-cli\packages\cli\src\ui\hooks\useConsoleMessages.ts", "TypeScript", 71, 0, 6, 13, 90
"d:\Web development\basic projects\projects fot job\potfoliio projects\portfolio projects\portfolioproject with livechat\portpolio-with-liveChat\gemini-cli\packages\cli\src\ui\hooks\useEditorSettings.test.ts", "TypeScript", 225, 0, 6, 53, 284
"d:\Web development\basic projects\projects fot job\potfoliio projects\portfolio projects\portfolioproject with livechat\portpolio-with-liveChat\gemini-cli\packages\cli\src\ui\hooks\useEditorSettings.ts", "TypeScript", 62, 0, 5, 9, 76
"d:\Web development\basic projects\projects fot job\potfoliio projects\portfolio projects\portfolioproject with livechat\portpolio-with-liveChat\gemini-cli\packages\cli\src\ui\hooks\useGeminiStream.test.tsx", "TypeScript JSX", 0, 881, 61, 117, 1059
"d:\Web development\basic projects\projects fot job\potfoliio projects\portfolio projects\portfolioproject with livechat\portpolio-with-liveChat\gemini-cli\packages\cli\src\ui\hooks\useGeminiStream.ts", "TypeScript", 698, 0, 40, 58, 796
"d:\Web development\basic projects\projects fot job\potfoliio projects\portfolio projects\portfolioproject with livechat\portpolio-with-liveChat\gemini-cli\packages\cli\src\ui\hooks\useGitBranchName.test.ts", "TypeScript", 183, 0, 16, 39, 238
"d:\Web development\basic projects\projects fot job\potfoliio projects\portfolio projects\portfolioproject with livechat\portpolio-with-liveChat\gemini-cli\packages\cli\src\ui\hooks\useGitBranchName.ts", "TypeScript", 59, 0, 11, 10, 80
"d:\Web development\basic projects\projects fot job\potfoliio projects\portfolio projects\portfolioproject with livechat\portpolio-with-liveChat\gemini-cli\packages\cli\src\ui\hooks\useHistoryManager.test.ts", "TypeScript", 166, 0, 7, 30, 203
"d:\Web development\basic projects\projects fot job\potfoliio projects\portfolio projects\portfolioproject with livechat\portpolio-with-liveChat\gemini-cli\packages\cli\src\ui\hooks\useHistoryManager.ts", "TypeScript", 76, 0, 24, 12, 112
"d:\Web development\basic projects\projects fot job\potfoliio projects\portfolio projects\portfolioproject with livechat\portpolio-with-liveChat\gemini-cli\packages\cli\src\ui\hooks\useInputHistory.test.ts", "TypeScript", 218, 0, 11, 33, 262
"d:\Web development\basic projects\projects fot job\potfoliio projects\portfolio projects\portfolioproject with livechat\portpolio-with-liveChat\gemini-cli\packages\cli\src\ui\hooks\useInputHistory.ts", "TypeScript", 91, 0, 7, 14, 112
"d:\Web development\basic projects\projects fot job\potfoliio projects\portfolio projects\portfolioproject with livechat\portpolio-with-liveChat\gemini-cli\packages\cli\src\ui\hooks\useKeypress.ts", "TypeScript", 73, 0, 20, 12, 105
"d:\Web development\basic projects\projects fot job\potfoliio projects\portfolio projects\portfolioproject with livechat\portpolio-with-liveChat\gemini-cli\packages\cli\src\ui\hooks\useLoadingIndicator.test.ts", "TypeScript", 109, 0, 9, 24, 142
"d:\Web development\basic projects\projects fot job\potfoliio projects\portfolio projects\portfolioproject with livechat\portpolio-with-liveChat\gemini-cli\packages\cli\src\ui\hooks\useLoadingIndicator.ts", "TypeScript", 42, 0, 7, 9, 58
"d:\Web development\basic projects\projects fot job\potfoliio projects\portfolio projects\portfolioproject with livechat\portpolio-with-liveChat\gemini-cli\packages\cli\src\ui\hooks\useLogger.ts", "TypeScript", 15, 0, 13, 5, 33
"d:\Web development\basic projects\projects fot job\potfoliio projects\portfolio projects\portfolioproject with livechat\portpolio-with-liveChat\gemini-cli\packages\cli\src\ui\hooks\usePhraseCycler.test.ts", "TypeScript", 102, 0, 20, 24, 146
"d:\Web development\basic projects\projects fot job\potfoliio projects\portfolio projects\portfolioproject with livechat\portpolio-with-liveChat\gemini-cli\packages\cli\src\ui\hooks\usePhraseCycler.ts", "TypeScript", 177, 0, 15, 9, 201
"d:\Web development\basic projects\projects fot job\potfoliio projects\portfolio projects\portfolioproject with livechat\portpolio-with-liveChat\gemini-cli\packages\cli\src\ui\hooks\usePrivacySettings.ts", "TypeScript", 116, 0, 8, 12, 136
"d:\Web development\basic projects\projects fot job\potfoliio projects\portfolio projects\portfolioproject with livechat\portpolio-with-liveChat\gemini-cli\packages\cli\src\ui\hooks\useReactToolScheduler.ts", "TypeScript", 280, 0, 11, 22, 313
"d:\Web development\basic projects\projects fot job\potfoliio projects\portfolio projects\portfolioproject with livechat\portpolio-with-liveChat\gemini-cli\packages\cli\src\ui\hooks\useRefreshMemoryCommand.ts", "TypeScript", 1, 0, 5, 2, 8
"d:\Web development\basic projects\projects fot job\potfoliio projects\portfolio projects\portfolioproject with livechat\portpolio-with-liveChat\gemini-cli\packages\cli\src\ui\hooks\useShellHistory.test.ts", "TypeScript", 155, 0, 17, 48, 220
"d:\Web development\basic projects\projects fot job\potfoliio projects\portfolio projects\portfolioproject with livechat\portpolio-with-liveChat\gemini-cli\packages\cli\src\ui\hooks\useShellHistory.ts", "TypeScript", 86, 0, 6, 12, 104
"d:\Web development\basic projects\projects fot job\potfoliio projects\portfolio projects\portfolioproject with livechat\portpolio-with-liveChat\gemini-cli\packages\cli\src\ui\hooks\useShowMemoryCommand.ts", "TypeScript", 62, 0, 5, 9, 76
"d:\Web development\basic projects\projects fot job\potfoliio projects\portfolio projects\portfolioproject with livechat\portpolio-with-liveChat\gemini-cli\packages\cli\src\ui\hooks\useStateAndRef.ts", "TypeScript", 23, 0, 9, 5, 37
"d:\Web development\basic projects\projects fot job\potfoliio projects\portfolio projects\portfolioproject with livechat\portpolio-with-liveChat\gemini-cli\packages\cli\src\ui\hooks\useTerminalSize.ts", "TypeScript", 21, 0, 5, 7, 33
"d:\Web development\basic projects\projects fot job\potfoliio projects\portfolio projects\portfolioproject with livechat\portpolio-with-liveChat\gemini-cli\packages\cli\src\ui\hooks\useThemeCommand.ts", "TypeScript", 93, 0, 12, 12, 117
"d:\Web development\basic projects\projects fot job\potfoliio projects\portfolio projects\portfolioproject with livechat\portpolio-with-liveChat\gemini-cli\packages\cli\src\ui\hooks\useTimer.test.ts", "TypeScript", 95, 0, 6, 20, 121
"d:\Web development\basic projects\projects fot job\potfoliio projects\portfolio projects\portfolioproject with livechat\portpolio-with-liveChat\gemini-cli\packages\cli\src\ui\hooks\useTimer.ts", "TypeScript", 41, 0, 15, 10, 66
"d:\Web development\basic projects\projects fot job\potfoliio projects\portfolio projects\portfolioproject with livechat\portpolio-with-liveChat\gemini-cli\packages\cli\src\ui\hooks\useToolScheduler.test.ts", "TypeScript", 916, 0, 24, 92, 1032
"d:\Web development\basic projects\projects fot job\potfoliio projects\portfolio projects\portfolioproject with livechat\portpolio-with-liveChat\gemini-cli\packages\cli\src\ui\privacy\CloudFreePrivacyNotice.tsx", "TypeScript JSX", 0, 98, 6, 10, 114
"d:\Web development\basic projects\projects fot job\potfoliio projects\portfolio projects\portfolioproject with livechat\portpolio-with-liveChat\gemini-cli\packages\cli\src\ui\privacy\CloudPaidPrivacyNotice.tsx", "TypeScript JSX", 0, 46, 5, 5, 56
"d:\Web development\basic projects\projects fot job\potfoliio projects\portfolio projects\portfolioproject with livechat\portpolio-with-liveChat\gemini-cli\packages\cli\src\ui\privacy\GeminiPrivacyNotice.tsx", "TypeScript JSX", 0, 49, 5, 5, 59
"d:\Web development\basic projects\projects fot job\potfoliio projects\portfolio projects\portfolioproject with livechat\portpolio-with-liveChat\gemini-cli\packages\cli\src\ui\privacy\PrivacyNotice.tsx", "TypeScript JSX", 0, 32, 5, 6, 43
"d:\Web development\basic projects\projects fot job\potfoliio projects\portfolio projects\portfolioproject with livechat\portpolio-with-liveChat\gemini-cli\packages\cli\src\ui\themes\ansi-light.ts", "TypeScript", 138, 0, 5, 4, 147
"d:\Web development\basic projects\projects fot job\potfoliio projects\portfolio projects\portfolioproject with livechat\portpolio-with-liveChat\gemini-cli\packages\cli\src\ui\themes\ansi.ts", "TypeScript", 142, 0, 10, 4, 156
"d:\Web development\basic projects\projects fot job\potfoliio projects\portfolio projects\portfolioproject with livechat\portpolio-with-liveChat\gemini-cli\packages\cli\src\ui\themes\atom-one-dark.ts", "TypeScript", 135, 0, 5, 4, 144
"d:\Web development\basic projects\projects fot job\potfoliio projects\portfolio projects\portfolioproject with livechat\portpolio-with-liveChat\gemini-cli\packages\cli\src\ui\themes\ayu-light.ts", "TypeScript", 127, 0, 5, 4, 136
"d:\Web development\basic projects\projects fot job\potfoliio projects\portfolio projects\portfolioproject with livechat\portpolio-with-liveChat\gemini-cli\packages\cli\src\ui\themes\ayu.ts", "TypeScript", 101, 0, 5, 4, 110
"d:\Web development\basic projects\projects fot job\potfoliio projects\portfolio projects\portfolioproject with livechat\portpolio-with-liveChat\gemini-cli\packages\cli\src\ui\themes\default-light.ts", "TypeScript", 99, 0, 5, 3, 107
"d:\Web development\basic projects\projects fot job\potfoliio projects\portfolio projects\portfolioproject with livechat\portpolio-with-liveChat\gemini-cli\packages\cli\src\ui\themes\default.ts", "TypeScript", 142, 0, 5, 3, 150
"d:\Web development\basic projects\projects fot job\potfoliio projects\portfolio projects\portfolioproject with livechat\portpolio-with-liveChat\gemini-cli\packages\cli\src\ui\themes\dracula.ts", "TypeScript", 112, 0, 5, 4, 121
"d:\Web development\basic projects\projects fot job\potfoliio projects\portfolio projects\portfolioproject with livechat\portpolio-with-liveChat\gemini-cli\packages\cli\src\ui\themes\github-dark.ts", "TypeScript", 135, 0, 5, 4, 144
"d:\Web development\basic projects\projects fot job\potfoliio projects\portfolio projects\portfolioproject with livechat\portpolio-with-liveChat\gemini-cli\packages\cli\src\ui\themes\github-light.ts", "TypeScript", 137, 0, 5, 4, 146
"d:\Web development\basic projects\projects fot job\potfoliio projects\portfolio projects\portfolioproject with livechat\portpolio-with-liveChat\gemini-cli\packages\cli\src\ui\themes\googlecode.ts", "TypeScript", 134, 0, 5, 4, 143
"d:\Web development\basic projects\projects fot job\potfoliio projects\portfolio projects\portfolioproject with livechat\portpolio-with-liveChat\gemini-cli\packages\cli\src\ui\themes\no-color.ts", "TypeScript", 83, 0, 5, 4, 92
"d:\Web development\basic projects\projects fot job\potfoliio projects\portfolio projects\portfolioproject with livechat\portpolio-with-liveChat\gemini-cli\packages\cli\src\ui\themes\shades-of-purple.ts", "TypeScript", 255, 0, 51, 43, 349
"d:\Web development\basic projects\projects fot job\potfoliio projects\portfolio projects\portfolioproject with livechat\portpolio-with-liveChat\gemini-cli\packages\cli\src\ui\themes\theme-manager.ts", "TypeScript", 92, 0, 20, 14, 126
"d:\Web development\basic projects\projects fot job\potfoliio projects\portfolio projects\portfolioproject with livechat\portpolio-with-liveChat\gemini-cli\packages\cli\src\ui\themes\theme.ts", "TypeScript", 274, 0, 49, 19, 342
"d:\Web development\basic projects\projects fot job\potfoliio projects\portfolio projects\portfolioproject with livechat\portpolio-with-liveChat\gemini-cli\packages\cli\src\ui\themes\xcode.ts", "TypeScript", 142, 0, 5, 4, 151
"d:\Web development\basic projects\projects fot job\potfoliio projects\portfolio projects\portfolioproject with livechat\portpolio-with-liveChat\gemini-cli\packages\cli\src\ui\types.ts", "TypeScript", 178, 0, 14, 27, 219
"d:\Web development\basic projects\projects fot job\potfoliio projects\portfolio projects\portfolioproject with livechat\portpolio-with-liveChat\gemini-cli\packages\cli\src\ui\utils\CodeColorizer.tsx", "TypeScript JSX", 0, 134, 32, 19, 185
"d:\Web development\basic projects\projects fot job\potfoliio projects\portfolio projects\portfolioproject with livechat\portpolio-with-liveChat\gemini-cli\packages\cli\src\ui\utils\MarkdownDisplay.test.tsx", "TypeScript JSX", 0, 236, 9, 36, 281
"d:\Web development\basic projects\projects fot job\potfoliio projects\portfolio projects\portfolioproject with livechat\portpolio-with-liveChat\gemini-cli\packages\cli\src\ui\utils\MarkdownDisplay.tsx", "TypeScript JSX", 0, 529, 6, 6, 541
"d:\Web development\basic projects\projects fot job\potfoliio projects\portfolio projects\portfolioproject with livechat\portpolio-with-liveChat\gemini-cli\packages\cli\src\ui\utils\TableRenderer.tsx", "TypeScript JSX", 0, 87, 14, 14, 115
"d:\Web development\basic projects\projects fot job\potfoliio projects\portfolio projects\portfolioproject with livechat\portpolio-with-liveChat\gemini-cli\packages\cli\src\ui\utils\commandUtils.ts", "TypeScript", 3, 0, 21, 3, 27
"d:\Web development\basic projects\projects fot job\potfoliio projects\portfolio projects\portfolioproject with livechat\portpolio-with-liveChat\gemini-cli\packages\cli\src\ui\utils\computeStats.test.ts", "TypeScript", 220, 0, 5, 23, 248
"d:\Web development\basic projects\projects fot job\potfoliio projects\portfolio projects\portfolioproject with livechat\portpolio-with-liveChat\gemini-cli\packages\cli\src\ui\utils\computeStats.ts", "TypeScript", 71, 0, 5, 9, 85
"d:\Web development\basic projects\projects fot job\potfoliio projects\portfolio projects\portfolioproject with livechat\portpolio-with-liveChat\gemini-cli\packages\cli\src\ui\utils\displayUtils.test.ts", "TypeScript", 46, 0, 5, 8, 59
"d:\Web development\basic projects\projects fot job\potfoliio projects\portfolio projects\portfolioproject with livechat\portpolio-with-liveChat\gemini-cli\packages\cli\src\ui\utils\displayUtils.ts", "TypeScript", 20, 0, 7, 6, 33
"d:\Web development\basic projects\projects fot job\potfoliio projects\portfolio projects\portfolioproject with livechat\portpolio-with-liveChat\gemini-cli\packages\cli\src\ui\utils\errorParsing.test.ts", "TypeScript", 99, 0, 5, 16, 120
"d:\Web development\basic projects\projects fot job\potfoliio projects\portfolio projects\portfolioproject with livechat\portpolio-with-liveChat\gemini-cli\packages\cli\src\ui\utils\errorParsing.ts", "TypeScript", 86, 0, 9, 12, 107
"d:\Web development\basic projects\projects fot job\potfoliio projects\portfolio projects\portfolioproject with livechat\portpolio-with-liveChat\gemini-cli\packages\cli\src\ui\utils\formatters.test.ts", "TypeScript", 52, 0, 5, 16, 73
"d:\Web development\basic projects\projects fot job\potfoliio projects\portfolio projects\portfolioproject with livechat\portpolio-with-liveChat\gemini-cli\packages\cli\src\ui\utils\formatters.ts", "TypeScript", 41, 0, 12, 11, 64
"d:\Web development\basic projects\projects fot job\potfoliio projects\portfolio projects\portfolioproject with livechat\portpolio-with-liveChat\gemini-cli\packages\cli\src\ui\utils\markdownUtilities.test.ts", "TypeScript", 35, 0, 7, 9, 51
"d:\Web development\basic projects\projects fot job\potfoliio projects\portfolio projects\portfolioproject with livechat\portpolio-with-liveChat\gemini-cli\packages\cli\src\ui\utils\markdownUtilities.ts", "TypeScript", 62, 0, 55, 9, 126
"d:\Web development\basic projects\projects fot job\potfoliio projects\portfolio projects\portfolioproject with livechat\portpolio-with-liveChat\gemini-cli\packages\cli\src\ui\utils\textUtils.test.ts", "TypeScript", 30, 0, 5, 7, 42
"d:\Web development\basic projects\projects fot job\potfoliio projects\portfolio projects\portfolioproject with livechat\portpolio-with-liveChat\gemini-cli\packages\cli\src\ui\utils\textUtils.ts", "TypeScript", 32, 0, 28, 10, 70
"d:\Web development\basic projects\projects fot job\potfoliio projects\portfolio projects\portfolioproject with livechat\portpolio-with-liveChat\gemini-cli\packages\cli\src\ui\utils\updateCheck.test.ts", "TypeScript", 67, 0, 5, 11, 83
"d:\Web development\basic projects\projects fot job\potfoliio projects\portfolio projects\portfolioproject with livechat\portpolio-with-liveChat\gemini-cli\packages\cli\src\ui\utils\updateCheck.ts", "TypeScript", 29, 0, 7, 5, 41
"d:\Web development\basic projects\projects fot job\potfoliio projects\portfolio projects\portfolioproject with livechat\portpolio-with-liveChat\gemini-cli\packages\cli\src\utils\cleanup.ts", "TypeScript", 11, 0, 6, 3, 20
"d:\Web development\basic projects\projects fot job\potfoliio projects\portfolio projects\portfolioproject with livechat\portpolio-with-liveChat\gemini-cli\packages\cli\src\utils\package.ts", "TypeScript", 25, 0, 6, 8, 39
"d:\Web development\basic projects\projects fot job\potfoliio projects\portfolio projects\portfolioproject with livechat\portpolio-with-liveChat\gemini-cli\packages\cli\src\utils\readStdin.ts", "TypeScript", 28, 0, 5, 7, 40
"d:\Web development\basic projects\projects fot job\potfoliio projects\portfolio projects\portfolioproject with livechat\portpolio-with-liveChat\gemini-cli\packages\cli\src\utils\sandbox.ts", "TypeScript", 669, 0, 117, 86, 872
"d:\Web development\basic projects\projects fot job\potfoliio projects\portfolio projects\portfolioproject with livechat\portpolio-with-liveChat\gemini-cli\packages\cli\src\utils\startupWarnings.test.ts", "TypeScript", 55, 0, 5, 16, 76
"d:\Web development\basic projects\projects fot job\potfoliio projects\portfolio projects\portfolioproject with livechat\portpolio-with-liveChat\gemini-cli\packages\cli\src\utils\startupWarnings.ts", "TypeScript", 25, 0, 12, 4, 41
"d:\Web development\basic projects\projects fot job\potfoliio projects\portfolio projects\portfolioproject with livechat\portpolio-with-liveChat\gemini-cli\packages\cli\src\utils\version.ts", "TypeScript", 5, 0, 5, 3, 13
"Total", "-", 17557, 9758, 2402, 3242, 32959